Play=Play
Settings=Settings
Quit=Quit
Audio=Audio
Global=Global Volume
Music=Music Volume
Sound=Sound Volume
Graphics=Graphics
VideoMode=VideoMode
VerticalSync=VerticalSync
Fullscreen=Fullscreen
Binding=Key Binding
UnlockK=Unlock
CollectK=Collect
Plant1=Plant1
Plant2=Plant2
Plant3=Plant3
Turret1=Turret1
Turret2=Turret2
Turret3=Turret3
Turret4=Turret4
Return=Return
Desc1=You have to grow you farm.
Desc2=BUT, Zombies will attack you !
Desc3=So you need to kick their asses with Turrets !
Skip=Press any key to skip tutorial
Money=Money
Wave=/!\ Wave : Danger
Tools=Tools
Seeds=Seeds
Turrets=Turrets
Unlock=Unlock land
Cost=Cost
Collect=Collect
Time=Time
Price=Price
Life=Life
DPS=DPS
NewWave=New Wave
Score=Score
AnyKey=Press any key
Menu=to go to Menu
