Play=Jouer
Settings=Configuration
Quit=Quitter
Audio=Audio
Global=Volume Global
Music=Volume Musical
Sound=Volume Sonore
Graphics=Graphismes
VideoMode=Mode Video
VerticalSync=Synchro Verticale
Fullscreen=Plein ecran
Binding=Commandes
UnlockK=Debloquer
CollectK=Collecter
Plant1=Plante1
Plant2=Plante2
Plant3=Plante3
Turret1=Tourelle1
Turret2=Tourelle2
Turret3=Tourelle3
Turret4=Tourelle4
Return=Retour
Desc1=Il faut travailler dans la ferme
Desc2=Mais, des zombies attaquent !
Desc3=Utilise des tourelles pour defendre !
Skip=Appuie sur une touche pour passer le tutoriel
Money=Argent
Wave=/!\ Nouvelle Vague
Tools=Outils
Seeds=Graines
Turrets=Tourelles
Unlock=Debloquer
Cost=Cout
Collect=Collecter
Time=Temps
Price=Gain
Life=Vie
DPS=DPS
NewWave=Vague
Score=Score
AnyKey=Appuie sur une touche
Menu=pour revenir au Menu
